README.os390	building and installing Perl for OS/390 and z/OS
README.macos	Perl under Mac OS (Classic)
README.qnx	Perl version 5 on QNX
README.hpux	Perl version 5 on Hewlett-Packard Unix (HP-UX) systems
README.netware	Perl for NetWare
README.amiga	Perl under Amiga OS
README.plan9	Plan 9-specific documentation for Perl
README.hurd	Perl version 5 on Hurd
README.freebsd	Perl version 5 on FreeBSD systems
README.aix	Perl version 5 on IBM AIX (UNIX) systems
README.cygwin	Perl for Cygwin
README.dos	Perl under DOS, W31, W95.
README.synology	Perl 5 on Synology DSM systems
README.irix	Perl version 5 on Irix systems
README.symbian	Perl version 5 on Symbian OS
README	About Perl
README.riscos	Perl version 5 for RISC OS
README.os2	Perl under OS/2, DOS, Win0.3*, Win0.95 and WinNT.
README.win32	Perl under Windows
README.micro	microperl is supposed to be a really minimal perl
README.bs2000	building and installing Perl for BS2000.
README.android	Perl under Android
README.ce	Perl for WinCE
README.vos	Perl for Stratus OpenVOS
README.tru64	Perl version 5 on Tru64 (formerly known as Digital UNIX
README.linux	Perl version 5 on Linux systems
README.macosx	Perl under Mac OS X
README.solaris	Perl version 5 on Solaris systems
README.vms	Configuring, building, testing, and installing perl on VMS
README.haiku	Perl version 5.10+ on Haiku
README.os400	Perl version 5 on OS/400
README.openbsd	Perl version 5 on OpenBSD systems
perldelta.pod	what is new for perl v5.20.0
perlinterp.pod	An overview of the Perl interpreter
perl5143delta.pod	what is new for perl v5.14.3
perltooc.pod	Links to information on object-oriented programming in
perl5181delta.pod	what is new for perl v5.18.1
perlop.pod	Perl operators and precedence
perlipc.pod	Perl interprocess communication (signals, fifos, pipes,
perldiag.pod	various Perl diagnostics
perluniprops.pod	Index of Unicode Version 6.3.0 character properties
perltoot.pod	Links to information on object-oriented programming in
perlgpl.pod	the GNU General Public License, version 1
perltie.pod	how to hide an object class in a simple variable
perlpolicy.pod	Various and sundry policies and commitments related to
perl589delta.pod	what is new for perl v5.8.9
perlartistic.pod	the Perl Artistic License
perlcall.pod	Perl calling conventions from C
perlsub.pod	Perl subroutines
perl5120delta.pod	what is new for perl v5.12.0
perlobj.pod	Perl object reference
perlexperiment.pod	A listing of experimental features in Perl
perlintro.pod	a brief introduction and overview of Perl
perl5125delta.pod	what is new for perl v5.12.5
perlpod.pod	the Plain Old Documentation format
perliol.pod	C API for Perl's implementation of IO in Layers.
perl58delta.pod	what is new for perl v5.8.0
perlapio.pod	perl's IO abstraction interface.
perlsec.pod	Perl security
perltrap.pod	Perl traps for the unwary
perldebguts.pod	Guts of Perl debugging 
perlref.pod	Perl references and nested data structures
perlcommunity.pod	a brief overview of the Perl community
perlapi.pod	autogenerated documentation for the perl public API
perl5144delta.pod	what is new for perl v5.14.4
perlpodspec.pod	Plain Old Documentation: format specification and
perlvar.pod	Perl predefined variables
perllol.pod	Manipulating Arrays of Arrays in Perl
perlunitut.pod	Perl Unicode Tutorial
perlrecharclass.pod	Perl Regular Expression Character Classes
perl584delta.pod	what is new for perl v5.8.4
perlmroapi.pod	Perl method resolution plugin interface
perl5142delta.pod	what is new for perl v5.14.2
perldtrace.pod	Perl's support for DTrace
perlform.pod	Perl formats
perlutil.pod	utilities packaged with the Perl distribution
perllexwarn.pod	Perl Lexical Warnings
perlrebackslash.pod	Perl Regular Expression Backslash Sequences and
perlopentut.pod	simple recipes for opening files and pipes in Perl
perlsyn.pod	Perl syntax
perldebug.pod	Perl debugging
perl.pod	The Perl 5 language interpreter
perlhack.pod	How to hack on Perl
perlreapi.pod	Perl regular expression plugin interface
perl5123delta.pod	what is new for perl v5.12.3
perlreref.pod	Perl Regular Expressions Reference
perlhacktut.pod	Walk through the creation of a simple C code patch
perl5160delta.pod	what is new for perl v5.16.0
perl56delta.pod	what's new for perl v5.6.0
perlpragma.pod	how to write a user pragma
perlpacktut.pod	tutorial on C<pack> and C<unpack>
perl5140delta.pod	what is new for perl v5.14.0
perlintern.pod	autogenerated documentation of purely B<internal>
perl5100delta.pod	what is new for perl 5.10.0
perlre.pod	Perl regular expressions
perl583delta.pod	what is new for perl v5.8.3
perlnumber.pod	semantics of numbers and numeric operations in Perl
perlunifaq.pod	Perl Unicode FAQ
perl5182delta.pod	what is new for perl v5.18.2
perlfork.pod	Perl's fork() emulation
perl5162delta.pod	what is new for perl v5.16.2
perltodo.pod	Link to the Perl to-do list
perldebtut.pod	Perl debugging tutorial
perlreftut.pod	Mark's very short tutorial about references
perl588delta.pod	what is new for perl v5.8.8
perlunicode.pod	Unicode support in Perl
perlmodlib.pod	constructing new Perl modules and finding existing ones
perlboot.pod	Links to information on object-oriented programming in
perl587delta.pod	what is new for perl v5.8.7
perl5180delta.pod	what is new for perl v5.18.0
perlembed.pod	how to embed perl in your C program
perl5122delta.pod	what is new for perl v5.12.2
perlperf.pod	Perl Performance and Optimization Techniques
perlmodinstall.pod	Installing CPAN Modules
perlebcdic.pod	Considerations for running Perl on EBCDIC platforms
perlgit.pod	Detailed information about git and the Perl repository
perl581delta.pod	what is new for perl v5.8.1
perlfunc.pod	Perl builtin functions
perlguts.pod	Introduction to the Perl API
perl582delta.pod	what is new for perl v5.8.2
perlretut.pod	Perl regular expressions tutorial
perlmod.pod	Perl modules (packages and symbol tables)
perldsc.pod	Perl Data Structures Cookbook
perlbot.pod	Links to information on object-oriented programming in
perl5141delta.pod	what is new for perl v5.14.1
perlrepository.pod	Links to current information on the Perl source
perlrun.pod	how to execute the Perl interpreter
perl5005delta.pod	what's new for perl5.005
perlstyle.pod	Perl style guide
perl586delta.pod	what is new for perl v5.8.6
perl5161delta.pod	what is new for perl v5.16.1
perlhacktips.pod	Tips for Perl core C code hacking
perl5121delta.pod	what is new for perl v5.12.1
perl5101delta.pod	what is new for perl v5.10.1
perlpodstyle.pod	Perl POD style guide
perlsource.pod	A guide to the Perl source tree
perlmodstyle.pod	Perl module style guide
perl5124delta.pod	what is new for perl v5.12.4
perldbmfilter.pod	Perl DBM Filters
perllocale.pod	Perl locale handling (internationalization and
perlrequick.pod	Perl regular expressions quick start
perlbook.pod	Books about and related to Perl
perl585delta.pod	what is new for perl v5.8.5
perlfilter.pod	Source Filters
perl5163delta.pod	what is new for perl v5.16.3
perluniintro.pod	Perl Unicode introduction
perlreguts.pod	Description of the Perl regular expression engine.
perlnewmod.pod	preparing a new module for distribution
perlhist.pod	the Perl history records
perlclib.pod	Internal replacements for standard C library functions
perl561delta.pod	what's new for perl v5.6.1
perl5004delta.pod	what's new for perl5.004
perlthrtut.pod	Tutorial on threads in Perl
perldata.pod	Perl data types
perlport.pod	Writing portable Perl
perlcheat.pod	Perl 5 Cheat Sheet
perlootut.pod	Object-Oriented Programming in Perl Tutorial
perlvms.pod	VMS-specific documentation for Perl
perlxstut.pod	Tutorial for writing XSUBs
perlglossary.pod	Perl Glossary
perlxs.pod	XS language reference manual
perlfaq6.pod	Regular Expressions
perlxstypemap.pod	Perl XS C/Perl type mapping
perlfaq9.pod	Web, Email and Networking
perlfaq4.pod	Data Manipulation
perldoc.pod	Look up Perl documentation in Pod format.
perlfaq7.pod	General Perl Language Issues
perlfaq1.pod	General Questions About Perl
perlfaq8.pod	System Interaction
perlfaq.pod	frequently asked questions about Perl
perlfaq2.pod	Obtaining and Learning about Perl
perlfaq3.pod	Programming Tools
perlfaq5.pod	Files and Formats
